
服务条款
以下是会计云课堂使用的第三方 SDK 的情况，我们将不时地更新此清单，以更清晰地展示会计云课堂与第三方合作或使用第三方功能以完善会计云课堂产品和服务体验的情况。我们会对 SDK 的接入和使用进行审核，以保障你的个人信息安全，也请你理解。

一、用于快捷登录或支持第三方登录的 SDK

我们仅在你选用该种登录方式时唤起 SDK ，以完成第三方登录所需的帐号密码核验等要求。

SDK 名称	提供商	备注
微信登录	腾讯	「第三方登录-微信」功能
QQ 登录	腾讯	「第三方登录-QQ」功能
微博登录	新浪微博	「第三方登录-微博」功能
一键登录	阿里公司	本机号码一键登录和认证
移动授权登录	中移互联网有限公司	移动用户一键登录
号码速验	上海德诚网联网络技术服务有限公司	提供一键登录服务
二、用于调用第三方功能以增强用户体验的 SDK

我们仅在你使用对应功能时唤起 SDK ，以使该功能呈现在会计云课堂，以帮助你获得更好的使用体验。

SDK 名称	提供商	备注
微信	腾讯	微信支付功能
Bugly	腾讯	应用程序故障收集和分析
支付宝支付	蚂蚁金服	支付宝支付功能
腾讯直播	腾讯	直播和直播回放播放功能
GrowingIO	GrowingIO	数据采集功能
友盟推送SDK	友盟+	消息推送
小能SDK	小能	客服沟通
ShareSDK	MobTech	分享，绑定微信/QQ/微博
腾讯X5浏览器内核	腾讯	H5浏览
腾讯IM	腾讯	群聊
阿里实人认证	阿里	实人认证
声网SDK	上海兆言网络科技有限公司	音视频通话
腾讯云SDK	腾讯科技（深圳）有限公司	数据存储服务
淘宝Agoo推送SDK	北京锐讯灵通科技有限公司	采集设备标识符
Glide	Glide	图片加载库
PictureSelector	本地图片选择工具	本地图片选择工具
xiaomi-push	小米科技有限责任公司	小米渠道官方推送
华为推送及华为组件	华为技术有限公司	华为渠道官方推送
淘宝、手淘安全组件	阿里云计算有限公司	保证设备支付环境网络安全
ijk视频播放器	上海宽娱数码科技有限公司	开源的视频播放器
Yalantis	Yalantis	图片裁切库
UC啄木鸟	广州市动景计算机科技有限公司	线上质量监控以及异常定位分析服务
腾讯灯塔	腾讯科技(深圳)有限公司	移动应用智能数据分析平台
腾讯VasSonic	腾讯科技(深圳)有限公司	网页加载速度提升框架
ExoPlayer	Google公司	开源播放器
ExoPlayer	Google公司	开源播放器
Cropper	Edmodo公司	图片裁切库
阿里Utils包	阿里云计算有限公司	阿里组件依赖的基础库
阿里OneSDK	蚂蚁金服(杭州)网络技术有限公司	阿里组件依赖的基础库
三、其他功能

我们使用以下 SDK 以解决一些特殊需求，例如故障收集分析、帐号安全性核验等。

SDK 名称	提供商	备注
Bugly	腾讯	应用程序故障收集和分析